      ::::  Б  ::::
Бапода          -  To quit, Give up, Retire (not negative if used as retire)

Баушита        -  (Explicit)

Баушитэй       -  (Explicit)

Бази           -  Called/Named

Баса           -  Window

Бойшэ          -  Loud

Боши           -  More

Баулата        -  To act like a fool despite everyone knowing you are of higher intellectual standing.

Бидоса         -  To throw a destructive tantrum/ to rampage destructively

Беколай        -  Endless/Bottomless

Беканоса       -  To go ahead with no prior planning or fore-thought

Беко           -  Empty/None/without

Божа           -  Delete/Erase

Бибаю          -  Bible

Будая          -  Peace/Content

Басанаё        -  Privatism/a person who enjoys being alone

Бежалана       -  Atheism

Белафое        -  Noble man/royalty

Бопа(ьлэ/ьчэ)  -  To pass by (in) just a moment (ago)

Балого         -  A person who is all muscle and no brains

Бабэ           -  To surprise/ shock

Бадэё          -  To dance 

Боку           -  Sport/sports


      ::::  П  ::::
Пайдэ           -  to have faith in something/someone/ To be faithful

Пайдэьго      - faith

Паэша          -  Red

Пали           -  To go

По-            -  Perfective tense

Пития          -  to Taste

Падали         -  Carpet

Пача           -  Door (Entrance)

Пасу           -  Hairy

Пайбэ          -  Bumpy

Пода           -  Door (Object)

Палоша         -  Cell phone

Пайчо          -  Enter

Пацели         -  To Drive(vehicle)

Поялуду        -  Find/Gain/Achieve (intentional knowledge, perfective see/look for)

Пализо         -  Pass/Happen

Пиявэя         -  Motivation/Motivated/Motivate

Пюзэ           -  Vagina

Полу           -  To arrive at destination

Поюлай         -  About to arrive

Пеялуэ         -  Flickering light

Пожиьдазо      -  To memorize

Пожи           -  To remember  (пожиго memory) 

Поёчи          -  To deal with someone (positive or negative) 

Пуэла          -  Flower

Пакёта         -  Good bye/farewell

Пакуэя          -  place, set * to box up, to pack (suitcase), Со то адэ пакуэяьчэьнэ " Did you put it on the table?". 

Пошида          -  To answer, Reply


      ::::  В  ::::
Валиьго        -  Sleep

Вали           -  To sleep

Вэла           -  Tired/Sleepy

(Ва)           -  Exclamation ending

Ватэ           -  To close/Shut

Вия            -  To feel like...

Вэмида         -  Annoyed

Вояке          -  Borrow/Lend(money)

Вэлосета       -  Science

Вэладо         -  Hotel  

Вэюса          -  To respond
 
Вопу           -  To set/Fix (something into position)

Вашилаго       -  Servant

Вашина          -  To save

Вула           -  Across

Вежила         -  Shine (Light reflecting off a smooth surface causing it to glow)

Важемода       -  Any alcoholic beverage (Generally used to refer to any Poison)

Виначела       -  To become extinct

Визану         -  Through


      ::::  Ф  ::::
Фэхалэ          -  (Explicit)

Фела           -  Expel waste

Фама           -  Blanket

Фаьуа          -  Air

Футо           -  To replicate/copy

Фелэя          -  To finish

Фочасе         -  Cold wind that burns to breath (also cold wind)

Фосе           -  Painful/pain

Фили           -  To steal/rob +ца = Fiend/crook/robber/thief

Фуже           -  Fool/Imbecile/Idiot

Фалуза         -  Prostitute/Whore (slut) (Female only)

(пуэла филиьца -  Flower stealer (A low life male that takes advantage of young women)

Фиясо          -  France/French

Фию            -  Odd/Awkward event

Фэнё           -  Odd person/Outcast (socially awkward)

Фэжапо         -  Weed

Фоша           -  Vine

Фэпэма          -   to evaporate *squander money, vanish, to forget, to cool off from being angry. 


      ::::  З  ::::
Занада            -  Give, hand down, pass on (be gifted to)

Занадаьго     -  Inheritance

Занатэши       -  To obtain, Acquire, "get"

За             -  At/on/In (Nonphysical realm)

Зина           -  Yet

Задай          -  To play
 
Золу           -  to Open

Зэмэ           -  Fast/speed

Зопалу         -  To move

Затому         -  To fix/repair

Зайчава        -  An interest in something

Замити         -  To have a fever/sickness (different from feeling sick)

Зежама         -  To tighten up/be tense

Зака           -  To stutter (often name for a fool that is loved)

Зопалуго       -  Movie/Film

Зопаку         -  Take/require/spend (all time related)

Зукэ           -  Penis

Зашоки         -  Power/Strength

Зехица         -  Jealous(person/-Ца = Jealousy)

Зудале         -  Park/Garden

Зачу           -  Opinion (Often pronounced Зашу)

Зопаэтэ        -  To Interact

Зопадэ         -  To React

Зиди           -  To translate 

Зидимо         -  To interpret

Зайто          -  Greetings/hello/hi

Замэкэ        - Home

Затому        - Caution, carefulness

Зоь              - indeterminate motion verb/prefix

Зима/ зима о         -  To return to, Resume (doing something, being somewhere)


      ::::  Ж  ::::
Жали           -  Happy

Жатанай        -  Beautiful

Жауда          -  Music

Жау            -  Sing

Жауьго         -  Song

Жаду           -  Might/maybe

Жадуа          -  Possible

Жаду(ьлэ/ьчэ)  -  Would/Would have

Жамэ           -  Like/such as/as

Жидай          -  To hear/listen

Жеги           -  Difficult

Жибэлэ         -  Mean/signify/represent

Жиди           -  To live

Живи           -  Blood

жуафа          -  To put pieces of something together

Жу             -  Out 

Жедане         -  Bellow

Жулия          -  To Pity/+ьго = a pity

Житэши         -  Born/birth

Женияли        -  A common Daza expression for any foreign person, happenings, items, or expressions (from the word 'General') meaning "That is just general foreign talk/crap - That is just how foreigners are))

Жумуй            -  Behind


      ::::  С  ::::
Синуда                 -  To trust

Синудаьго            -  Trust (noun)

Салай          -  Than / compared to...

Соьнэ?         -  What?!

Со...ьнэ       -  (?)...?

Саху/Саьу      -  Day/Sun  (Эла Саху - Today)
 
Саьлунэ        -  Good night (acknowledge the rising moon)

Саьсаьу/сасаху -  Good morning (acknowledge the rising sun)

Са(-)          -  Bright/White/light

Саь-           -  Salute/acknowledge (ALWAYS a prefix)

Саматэ         -  Please

Си-            -  Warm

Сулу           -  Easy

Собатэ         -  Whatever

Сиция          -  Lecture/Class

Сихала         -  Desert (Ancient translation - Sahara)

Савуэ          -  To bow in thanks

Савону         -  To bow in greeting/leaving

Сияна          -  Mist/steam

Саеша          -  Star(s)

Сиядеша        -  Absolute/Obvious/ (Of course!)

Севэзиду        -  Hell

Симэю          -  Entertain

Сезадо         -  To proclaim

Сапо           -  Perspective/point of view

Силай          -  To rotate/spin

Сафэта         -  A Date, To Court

Сушaниха       -  A person who believes they know everything and act like they do.

Сожата         -  Above

Седможе        -  To die by falling from a very high height

Сасакэ         -  Daily (Коьэлаькэ саху)

Сайжу          -  Degree

Сачату          -   Doughnut 

Сай               -  A particle which is used to mark an idiomatic expression. ((Эла наьё сай маьмаушита. - This is my, so to say, kitten.))


      ::::  Ш  ::::
Шамало      -  Type / Font  (дазо шамало - Typing)

Ши             -  Sky

Шаумэ          -  Color
 
Ше             -  Yes

Шава           -  Speak/Say

Шами           -  Word

Шикэ           -  Tree

Шокэ           -  Bush

Шиму           -  Quiet

Шуй            -  Smooth

Шанэ           -  To ask/Inquire 

Шамаки         -  Notebook

Шё             -  Still (but still, more)

Шуалэ          -  Fly

Шитука         -  Metal (item/NOT substance)

Шолу           -  School (often pronounced Шёлу)

Шадияно        -  To describe (in detail)

Шута           -  Child/Kid

Шалоши         -  Strap/Wrap

Шопалено       -  Journey through life

Шиядуэ       -  Collected/Group/Collection

Шае            -  Correct/Right/True

Шаекоу         -  Righteous(person)

Шаку ханади    -  To spread disease

Шойфэ          -  To paint

Шабэ           -  To discuss/argue

Шаё            -  To snow

Шавалэгоьца    -  Prophet (One who speaks of future)

Шукау          -  The inability to speak intelligibly (unable to argue a point logically)

Шапэжу         -  Progress/continue

Шонадэ         -  "I am indifferent to your current choice, I won’t stop you."(Go for it.)

Шомияли        -  To spread out your body (also to spread fingers/toes/arms)

Шмэда          -  To indirectly influence someone to do something. 

Шедуа          -  An elder/Wise man

Шисия          -  A question

Шенукэ         -  To insert something into another object (common slang term for having sex)

Шепала         -  So far away it is unknown (it doesn't matter because it is so far away)

Шугини         -  To be ruined by getting wet

Шела           -  Beyond

Шома           -  Body


      ::::  Г  ::::
Гекай          -  With/Along with

Генай          -  By/Next to/with

Гаши/Гашиьго   -  Message

Гитэ           -  To care(about)

Гаьоло         -  Remote control

Гайчэ          -  Table

Газа           -  Tall

Гуьо           -  Most

Гия            -  Least

Гихаю          -  To deter (from doing something/path)

Гайкаба        -  To climb

Гичаю          -  Design

Гопало         -  Distance

Гоюкае         -  District

Гэлу                -  To blame, hate for

Гэлудуналэна / гэдуна     -  To blame someone for something, and then take revenge


      ::::  К  ::::
Кэнуша     -  Keyboard

Куцо          -  The/A Reason

Ко             -  Plural Prefix

Коьна          -  We (excluding)

Коьто          -  You (plural)

Коьнаьё        -  Our (excluding)

Коьтоьё        -  All of yours

Коьадэ         -  They/Them

Коьадэьё       -  Theirs

Коьабо         -  Fourth person plural (theoretical)
 
Коьабоьё       -  Fourth person plural possessive (theoretical)

Куэно          -  Us (inclusive)

Куэноьё        -  Our (inclusive)

Кувэза         -  Season

Коьэлаькэ      -  Universal /Everything /All
 
Куна           -  Time(when)

(ь)Кэ(ь)       -  Unifying/Binding/Connecting

Киьё           -  To have/Own

Кало           -  Disk

Кутужа         -  Intend (to do...)

Кэшаё          -  To return (from somewhere/doing something)

Кэшаёьдазо     -  To return (an item after use)

Каба           -  To demand

Какудэ         -  Number

Калатэ         -  Karate

куата          -  Room

киюду          -  Hallway

каетаё         -  to build

Каетаьго       -  Building

куобо          -  Complex

Кэше           -  Back

Кэнуй          -  Board

Куано          -  standard, cannon, base, model, ideal. (From KiSwahili Kiwango).

Куаноьдазо          -  to standardize, to model, to base something off of.

Киепо          -  unique, custom, original. киепоьдазо: to customize, to personalize, to originate, to make unique, я киепо to be the first to do something.


      ::::  Д  ::::
Да             -  On

Ду             -  Intention

Дуцо           -  In order for...

Даза           -  People/person

Дазо           -  To do/Make

Добай          -  Good

Дэ             -  Cause of

Дэцо           -  Because

Дафэ           -  Hard(to feel)

Диято          -  Friend
 
Дазуэя         -  Imagine/Dream(up)/Create (Also, stronger form of Дазо)

Давета         -  To suggest

Далени         -  To consider(claim)

Дюша           -  Heart/Spirit/soul

Дэкашето       -  History

Дайюла         -  Angel(s)

Далэха         -  To be greedy

Дазотая        -  To divide, break into pieces

Дуэна          -  Actuality, it is a fact that...

Дипюха         -  Tattoo

Ди...уди       -  The number... (advanced grammar structure)

Демаями        -  To force one’s own ideology and opinions of any subject onto another individual (Демаямиьца = Cult leader / a popular insult of women)

Дифу           -  Smoke

Дулахани       -  A person who lies to make themselves sound better

Дазушнэ        -  Ultimate/awesome

Девой          -  Empty container

Дице           -  Snack/treat/candy

Дучуая         -  A low life

Димиле         -  A shady character/suspicious individual

Дэшига          -  A bell/chime/occasionally knock

Дулети         -  Arrow (showing direction)

Дезакуа        -  Desire to be in another location

Дифузаха       -  A slang term for a German (or a large, loud, obnoxious and violent individual)

Дэчaти         -  Fire materials

Дайшикэ        -  Branch

Дайсо          -  Arm

Докай          -  Based

Добайьдокэ     -  Best

Добайьдо       -  Better

Дазаьтэй       -  Boy

Дазаьта        -  Girl

Дебарэй        -  British (English)

Дабеку         -  Final

Дэчай          -  Fire

Дахай         -  To burn

Дахайьдазо   -  To ignite, to make a fire

Доку             -  The way/how (to do something)

Дамуй           -  In front/ Front

Дуэшикэ        -  Forest


      ::::  Т  ::::
Тэдиёсоти          -  Teddy bear

Тачу           -  Maybe/just may/Might

То             -  You

Тэйза          -  Men

Таза           -  Women

Тоьё           -  Your

Тапа           -  Only/just

Тэши           -  Begin

Така           -  Clock

Такуа          -  to Fight/((combat))

Татика         -  Attempt/try

Такуаёши       -  "Combat from the heavens" Hand to hand martial arts combat style developed by Daza Monks. The main movements in this art are developed by the patterns of the constellations.

Таба           -  Equal (occasionally - The same)

Телияса        -  War/Battle

Такаше         -  Story/NOVEL/Epic novel (not small story)

Тиядава        -  Wise (Old translation - Ancient)

Тачэ/Талэ      -  After/Before

Талушия        -  Projector 

татэ           -  To get along with someone (Ie. I get along with him)

такуаму        -  Physical defense (To defend physically)

таеку          -  Mental defense (Also used with opinion and spiritual)

Туэго          -  Data


      ::::  Л  ::::
Лэуа           -  To wait

Лаку           -  Deep

Ло             -  In/Inside

Лу-            -  Dark/Black

Луэ            -  Moon

Луэькону       -  Night/(Time of the moon)

Ланай          -  To love(lover)

Лугами         -  Lamp

Лича           -  Pen

Лиюча          -  Marker

Лэпа           -  Short

Лозэ           -  Less

Леко           -  Full

Луго           -  Picture/image

Лайта          -  Daughter

Ладюша         -  Sweet heart (loved young one/NOT FOR MATES)

Лайтэй         -  Son

Ловай          -  To admire (Admiration)

Луно           -  Alone/Single

Лахаса/Лаьаса  -  Father --- (Tongue/Land etc)

Лауа           -  Dad/Father

Лаюси          -  Russian

Лавай          -  Fantasy

лулумэ         -  Stairs

ледано         -  Ridged
 
лапуса         -  To swim

Лопуаса        -  A slang term for French people (also used to describe arrogant stubborn people)

Лучинэ          -  To be antisocial/secluded/shy

Лайза          -  To fall on top of something/someone

Лэшига          -  To overflow/wash over/emerge

Ласаласа       -  Slang term for Spanish people (also a way to tease people who talk to fast)

Лукуэ          -  Outside of something

Лаудачифа       -  A sound from far away

Лушиду          -  To dig in the ground (also to seek out hidden information)

Ленасе         -  Hill

Лусифия        -  Ultimate Evil

Лиянэ          -  The way to do something correctly

Ладоку         -  Answer (in reply to something, To Answer) 


      ::::  М  ::::
Муэжа          -  Death (муэжаьца - dead{person})

Маушита        -  Cat

Мэя            -  To Know

Мэяьго         -  A thought

Муьмэя         -  Brain/Head

Моку           -  No

Мо             -  Tongue/Language

Май...ьма      -  (not)...Isn't

Мукэ(Мухэ)     -  Sex(to have it AND noun, since they are the same)

Мия            -  World
 
Мияьало        -  Internet (Electric world)

Можо           -  Should/Ought to ((I WILL do[A]))

Маьужало       -  Deactivate

Маьмэя         -  Stupid

Мупэ           -  To kiss

Мошия          -  To Read

Мику           -  Rodent

Мияй           -  Cute/Adorable

Мияау          -  Handsome

Мэлосу         -  Demon/Monster

муэьдазо       -  To scare (make afraid)

Минэя          -  Doubt

Муэ            -  Fear

Мажика         -  Magic (borrowed, since Daza people do not believe in 'actual' magic, calling it Devil worship, this Magic refers to the sleight of hand show magic introduced by foreign travelers.)

Муци          -  Nose

Муьада          -  Chin

Мужо          -  Ear

Муйша          -  Face

Муьчуку          -  Neck

Мухишу           -  Vitamin 

Мэ              -  Multidirectional Particle (similar to preposition 'about') attaches to the end of verb of motion.

Мэяло              -  Computer

Минай            -  Lake

Мишау            -  River


      ::::  Н  ::::
Ноука         -  Pay

Нога          -  Cost

На             -  Me/I
 
Най            -  Love(noun)

Наьё           -  My
 
Назе           -  Here
 
Натия          -  There

Наьнэ          -  Where?(always question)

Назеьни        -  Center

Наьшэ          -  North

Наьви          -  East

Наьфа          -  South

Наьтай         -  West

навадэ         -  To jog

нопай          -  to devise (come up with something)

нойшава        -  To preach

Низакэ         -  Bridge

Ниядиха        -  Extremely

Нёмеда         -  Pig (Also very popular way of describing a fat lazy person who doesn't contribute anything to society (worthless))

Нулия          -  Large empty space (not outer space, also used as a popular insult towards someone’s intelligence)

Нагижака       -  A native to the land (native American, Native Chinese, Native Indian. The first people to be settled in any area, also used of the founding members of clubs and organizations)

Нуколи         -  To look through something

Нию          - To Deserve

Налозе          -  Between


      ::::  Ч  ::::
Чабота         - To work, be employed

Чаботаьзой       - To work hard, toil, work as slave/servant

Чаму           -  But/Whereas

Чанай          -  To Love/Like (something) (Enjoy doing)

Чолу           -  To Eat

Чи-            -  Cold

Чакэ           -  Bag

Чуэну          -  To clean/wash

Чичоуа         -  Refrigerator/Freezer

Чия            -  Glass

Чинэё          -  Mirror

Чуа...Ежа...   -  "While ... is happening (so is) ..."

Чэялуа         -  To show (somebody how to do something)

Чияло          -  To show (somebody something)

Чиеко          -  Literate

чэкай          -  To rip or tear

чабахэ         -  To work/Function

Човадо         -  Restaurant

Чекаси         -  A vow of purity (verb)

Чутэё          -  To die from suffocation or a blocked air way

Чотияхи        -  Malicious/violent

Чабаьго        -  Business

Чияшита         -  Indifferent to ones immediate surroundings (often used of young girls to refer to them as 'day dreamers')

Чикэшитай       -  Metal bindings (very free word, used of anything metal that binds two objects or more together, door hinges, spiral notebooks, and even wedding rings)

Чаушито         -  A group of material bonded and fused together (Dreadlocks hair, welded pieces of metal, more concrete than Чикэшитай which doesn't mean fused together)

Чикия          -  To cut/ make incision. 

Чико          -  A Smile (noun)

Чикоьтэши          -  To Smile (verb)

Чикоьдазо          -  To Make Someone Smile

Чимо          -  Lip

Чичи          -  Teeth

Чимочи          -  Mouth

Чаболу            -  Homework


      ::::  Ц  ::::
Цеги           -  Car

Цо             -  That/Which

Цолу           -  To Drink

Ция            -  To Smell

Цахо           -  To Cut

Цию            -  Wall

Цажа           -  Salt

Цафи           -  Pepper

Цени           -  Unique/original

Цэза           -  Beginning (to begin)

Цатокэ         -  Ones inner(true)self

Циябуда        -  Simple-ism (What Daza monks strive for)

Цюдо           -  To Stand

Цожа           -  A Drink, refreshment, soda

цашай          -  Mist  

Цуни           -  Basic

цуди          -  Hood (suffix) parenthood, childhood, neighborhood 

(цуди шута     -  childhood 

(цуди дока       -  neighborhood.


      ::::  Х  ::::
Хэя+           -  About to/Have just...

Хэцэча       -  Consonant 

Хэя            -  Soon(no tense marker)

Хибай/Ибай     -  Hungry

Хишай/Ишай     -  Thirsty

Хиша           -  To Jump

Хада           -  Box

Хаясова        -  Philosophy (To be philosophical in thinking)

Хидоя/идоя     -  To Relax/take a break/rest

Хадинаги       -  Relationship (noun, to have one)

Хучибэ         -  To replace

Хата           -  Square

Хясоьца        -  Determined (Individual)

Хазай          -  To Develop

Хазачэмэ          -  Development

Хишупэьца         -  Doctor, Medic

Хишупэ             -  Medicine

Хишу                -  Health

Хипэшома       -  To Heal, cure

Хогу                   -  To get caught up in something *to gargle, have emotions rise up, something come to light, float/rise, brainstorm, spring of water(noun).

Хай               -  Flame


      ::::  А  ::::
Алова          -  Power

Адэ            -  He, She

Адэьё          -  His, Her

Або            -  Fourth person
 
Абоьё          -  Fourth person possessive (Rarely used)

Аги/Хаги       -  To want

Абиша          -  Yellow

Авуно          -  Sound
 
Авугайсу       -  Pronunciation

Айка           -  Scissors

Амежи          -  Angry

Ата            -  Too (much/many)

Аь             -  Hey!, Yo! (Hey you over there!) (Аь натан!) ((vocative marker))

Аши            -  To Need (for use)

Адакуасэ       -  Excuse me/Pardon me

Агаса          -  Curse (To curse)

Акато          -  Lie/To lie/False

Акатоца        -  Actor(Actress)

Акатуай        -  America (united states)

Аякуача        -  Clock

Афутикэ        -  African

Афуте          -  Africa (continent) 

Азу            -  Called (I am called ---)

Ажола          -  Named (formal - My name is --- --- ---)

Айвия          -  Leaf

Аёпа          -   Run off, escape, be a refugee, be a fugitive (always dealing with escaping/dodging gov or authority.), to skip class/play hooky. конаьё аёпа шолу чэ (We skipped school). адэьтэй аёпаьго (he missed his chance, oppotunity, chance to escape). 

Апаса          -  Hair


      ::::  О  ::::
Оку           -  Help/ Aid

О              -  Direction towards

Онижатэ        -  Thank you

Одазу          -  Wire/Cord

Оя             -  Bouncy

Оба            -  Lets(col. - Lets go, let’s stop, let’s play)

Ошия           -  To Believe

Омужида        -  Desperate

Отажи          -  To Zip (+Ьго = Sipper)

Ома            -  From/Of (На ома Акатуай)

Огау           -  Dog (More formally - Canine)

Омуа           -  Cow (Bull(male cow) - Биюа)

Омика          -  Button (on clothing)

Оедаги         -  Handle (on door or for carrying items)

Оуай           -  Island (Also for Hawaii//Philippines - Офауай)

Отоме          -  Soldier (Ancient translation - Warrior) (ottoman)

Отеда          -  Pocket

Отая           -  Hidden/Secret

Оцужи          -  Expression/To express

Опюхе          -  Drugs (non-medical)

Одилэда        -  Diagnosis/Problem/Dilemma

Оякунэ         -  And what about now? What to do now? ((Often pronounced "Сояхунэ?"))

Отимана        -  To conjure up from nothing/to appear from nothing 

Очизай         -  Microscope/binoculars

Отичай         -  Screws/nails

Очупай         -  Map/chart/globe

Омикаде        -  To almost physically die but overcome it (usually from illness, commonly said of exaggerating children)

Офияли         -  Half working (common insult to intellect)

Озада          -  Upload

Отаю               -  Remain 

Отаюьдазо        -  To leave, to keep, to store, 

Отаюца             - To live at/in/on. на отаюца

Опату                -  To throw or cast *launch (comp. program), launch, send off, cast out, send someone out to do a mission, send a long distance message. 

Обяти          -  Apple


      ::::  Э  ::::
Эёчуэ          -  Field

Эно            -  You and I
 
Эшиьки         -  To write

Эшиьго         -  Writings(letter/book)

Эла/Уэла       -  This, It, That

Элаго          -  Thing

Экуэ           -  Now

Экуэьлэ        -  Later

Экуэьчэ        -  Back Then/Earlier

Эь             -  Hmmm, ummm (every language has it)

Эе             -  Sure, mhmm, yeah, ok, (why not)

Эуа            -  Nature (get it? lol)

Эчуай          -  Continent

Эчу            -  Land (More formal - Country)

Эчуша          -  Brown (Land colored)

Эдоту          -  An Idealistic person (more formal - Planner)

Эшовеца        -  A social person/Conversationalist

Эшулая         -  Fundamentally (-Я = Fundamentals) 

Эчомало        -  Grocery store/Market

Экуамузэ       -  Theology

эсабо          -  To study

Этине          -  To be fun/have fun

Эшатуа         -  Book smart/Intelligent in literature

Эчежда         -  To foretell an event

Эпело          -  Logic

Эхи            -  To giggle quietly

Эцела          -  To sneeze

Экахна         -  To have a sore throat/to cough
 
Эдежаги        -  nervous/worried of an outcome 

Эгосифе        -  An extinct species

Эвияму         -  To be blurry

Элядо          -  Both

Эжи              -  Backwards, Reverse

Эзата             -  Below, Under


      ::::  И  ::::
И                -  Of (adjective mutation particle)

Инала          -  Taliban Feminist nazi-bot

Илута          -  Wife

Илутэй         -  Husband

Ижу            -  Still (continuous action)

Изау           -  Need/Must/Have to

Иьёла          -  To Carry

Иьё            -  To Hold

Ибасэ          -  Arid

Идая/Хидая     -  To consider

Ичой           -  To Repeat

Ипато          -  To Try (something new)

Ико            -  Then (so then)

Икону          -  Well then I suppose...

Иесой          -  Bench/Couch/Cot/Sofa

Иьияка         -  Gay/Lesbian

Ишувуа         -  Bad language (dirty mouth)

имуда          -  Plant

ичиха          -  Ice

Июка           -  Animal/Creature/Beast (non-domesticated)

Икиятаку       -  To hunt

Ияшё           -  Therefore (due to the previous information)

Икалуй         -  A person wearing clothes that irritate someone else (due to ugliness)

Ишатойзе        -  A light covering of dirt of garbage on a flat surface

Инайшэка       -  A love story (story about love)

Ицуа           -  Corner

Ичатумия       -  Cancer (The noun, and the action of being killed by it)

Илэйну         -  Tire/Wheel (round/circle when following adjectival modifier Иь)

Икише          -  A formal suit/dress 

Илэну          -  Ball

Ику            -  Like (Idiomatic, "Something LIKE A Something") [NOT the verb "to like" something/one]

Икалоьпали          - circumvent *to surround (with troops), to envelope

Икалоьчикия          -  to circumcise. 

Икалоьчикия муьмэя    - to decapitate ичия (short form) 

Июши               -  Mouse (computer)


      ::::  У  ::::
У              -  (Displacement prefix)

Укэда          -  Caterpillar

Унация         -  Over there
 
Укой           -  But/However/Although

Улай           -  Water

Уэка           -  Network/Routes ((two way))

Улайшиё        -  To Rain ((By itself = looks like it is raining.))

Ужи            -  To touch

Уэпа           -  To Walk

Ужало          -  To Activate

Ушай           -  Soft

Уави           -  Wet

Умави          -  Dry

Ука            -  Sticky

Уэдажи         -  Animal(domestic/pet)

Уабэзо         -  To breath

Учения         -  Futile/Pointless

Удели          -  Useful/helpful

Уэнё           -  Odd thing/Strange/Weird

Уаёлэ          -  Sensitive

Уиё            -  Fragile

Уьа!           -  Hurray, Yay, Goody

Ужане          -  Pleasant (Col. Goody!, Alright!)

Улису          -  Money

Улагеди        -  Purse (Геди - Hand bag/Wallet)

Уникэ          -  Pony tail/Head band

Уса            -  About, Dealing with (particle)((усаьго: a deal))

Унаги          -  To cry

Уэуэ           -  To weep (usually babies only)

Учёша          -  To tumble (fall dramatically, used when saying "I fell in love" Lit: "I tumbled dramatically into love" See translations.)

Уэдё           -  To apologize (на уэдё: I'm sorry)

Упали          -  To travel 

Учая          -  Eye

Унуа             -  Fruit 

Униши        -  Mouse (animal)

Уня            -  Tail


      ::::  Ь  ::::
Ьзой          -  A more intense action (Added to verbs to intensify them)

Ьё             -  Possessive suffix

Ьчэ            -  Past tense

Ьдэ            -  Cause of

Ьлэ            -  Future tense

Ьзэ            -  By use of...(Non hand wielded items/vehicles)

Ьки            -  By use of...(Hand wielded items)

Ьго            -  Inanimate (Genderless) Modifier

Ьта            -  Feminine Gender modifier

Ьтэй           -  Masculine Gender modifier
 
Ьво            -  Neuter Gender modifier (animate)

(Татэво)       -  (Gender)

Ьтэши          -  To become

Ьца            -  A doer of a verb

Ьало           -  Electricity(SUFFIX ALWAYS)

Ьдокэ          -  -Est
 
Ьдо            -  -Er

  
      ::::  Я  ::::
Я              -  With (adverb mutation particle)

Ягоё           -  Vowel

Ялу            -  To look/See

Януэша         -  Blue

Яца/Яцу        -  And/Also

Якой           -  Already

Ямикотэ        -  You're welcome

Яьо/Яхо        -  Could/Can/Able to

Яза            -  Permitted to/Allowed to

Яьоми/Яхоми    -  Known Ability/Able to through learning.

Ялаша          -  Slow

Ялуду          -  To seek/Search

Ялуьтэши       -  To encounter/find/happen upon (unintentional knowledge)

Ялаца          -  Glasses

Якуа           -  Watch/Hand clock

Яму            -  Mother/mom

Яшию           -  Written language

Яьилай         -  Black/white board (modern use: projector screen)

Яноша          -  To explain

Язито          -  Particular (picky)

Ядета          -  Debt

Ягэсо          -  Brave (modern - Determined)

Яполе          -  Japan, Japanese

Яжимо          -  To confuse, vex, perplex

Яипу           -  Egg

Яжуна          -  Video/movie


      ::::  Ё  ::::
Ёчаботаьца      - Unemployed by choice,  / To be taken as a disciple

Ё              -  Direction from

Ёнуьало        -  Power Outlet

Ёпайчо         -  Exit

Ёбэ            -  Alas, and thus

Ёмукуэла       -  Danger(ous)

Ёмэяза         -  To comprehend/understand

Ёду            -  Until

Ёхайлу         -  To notice/Find out through observation

Ёчего          -  Interesting

Ёчино        -  To reflect (+ Ьго = Reflection)

Ётолуа         -  Water pipe

Ёзада          -  To Download

Ёдаьало/Ёдахало  -  To Charge (battery)

Ёда            -  To take/bring

Ёдаьоло        -  To take in/consume/bring in

Ёдаьжу         -  To take out/remove (Жу: out)

Ёдамэя         -  To Learn  

Ёсэяго         -  Difference

Ёсэя           -  Different

Ёнамой         -  Direction

Ёнамиё         -  Directly

Ёдаьчэ         -  Brought

Ёдусу            -  To Buy


      ::::  Е  ::::
Едусу         -  To Sell

Еда            -  To give

Еданай         -  To forgive

Ека            -  Or

Есо            -  to Grab

Енако          -  Room

Едага          -  Road(path)

Егами          -  Rough

Екэ            -  Sick

Елигу          -  Bad

Едаши          -  Weather

Ебоя           -  To Think

Еволэйкапа     -  The continent of Europe excluding Scandinavia and old Soviet States.

Едитакасу      -  Hand to hand combat, (for possession)

Ели            -  If

Екитоя         -  Terrible odor that stings the nostrils

Есоу           -  A leader of leaders, Capitan (col. for person in group who knows what to do.)

Едаьало        -  Charge(give power)

Еша            -  Small/little (size)

Еьо            -  Turn/time to go (Со еьо дазаьнэ?)

Ехала/Еьала    -  Special/Important (Ancient translation = Sacred)

Ежули          -  Street/path/walkway/road

Епалодеша      -  A journey taken to find meaning or purpose (A common Daza tradition)

Епало          -  To Stroll/for a walk

Ешэй           -  Need/Require (life or death)

Ешияху         -  Ugly/Hideous/Gross(item)

Емэза          -  Classroom

Емуа           -  Bottle (for drinks)

Епа            -  To sit

Едамэя         -  To teach

Едалу          -  It appears/seems

Екава          -  To test

Е              -  Even(more)/Extra

Енудай         -  Self/Individual/Alone(of people only)

Едимуа         -  Colloquial/Slang

Ецатешо        -  Suffering/To suffer

Ечатай         -  Hey everyone! ((more common = Аьечатай!))

Еуна           -  Extremely attractive woman (non-sexual)

Ешaкуцо        -  The reason/Cause/ or motive to do something

Ешанефуде      -  A person who enjoys causing other people misfortune and pain

Ефюде          -  Demon/Problem causing force/ Bad luck
 
Ецашонэ        -  Without parents, or anyone who raised oneself

Едису          -  Bill

Ешадо          -  Basis

Ечоа             -  Alternately (To do something by an alternate method.) Verb+чоа

Есоьало          -  Overthrow

      ::::  Ю  ::::
Ю              -  How/So/Very "So cute! How adorable! Very handsome"

Юга            -  Very/Much/Really(lots)/Many

Юшой           -  Bed

Ючэьго         -  Fat(noun)

Ючэ            -  Being fat/to be fat

Юбо            -  New

Юмабо          -  Old

Юша            -  Desk

Юдатэй         -  Brother (Дь тэй: Bro/bud/dude)

Юдэта          -  Sister

Юфизе          -  Toilet

Юдагой         -  Huge/Big/Large (size)

Ютэда          -  Due

Ютэ            -  Debt

Юцэва          -  Direct

Юкаето         -  Department

Ювоце(ьчэ)       -  To Decide(ed)

Ювоце          -  Decision

Юкэя             -  Hour 

Юдазо          - Busy/In the middle of doing many things
